############
#  ###     #
#        ###
#   #   # ##
#   # #    #
## # ## ## #
#    #  # ##
# #  ##    #
# ## #   # #
#          #
# #   #    #
############
